 XXXXOXXXXX 
NX  XXNX  XX
XX  NXXX  XN
 XXXXXXNXXX 
XX XX  XX XX
1X NN  NN NN